#####
#...#
#.#.#
#...#
#...#
\robot 1 0